#######################################################################
##                                                                   ##
##                                                                   ##
##                                                                   ##
##                                                                   ##
##                                                                   ##
##                                                                   ##
##                                                                   ##
##                                                                   ##
##                                                                   ##
##                                                                   ##
##                                                                   ##
##                                                                   ##
##                                                                   ##
##                                                                   ##
##                                                                   ##
##                                                                   ##
##                                                                   ##
##                                                                   ##
##                                                                   ##
#######################################################################